Map of globals:

a = audioCtx
b = shader
c = canvas
d = audio
e = collisions
f = fftDataArray
g = gl
h = init
i = loop variable
j = loop variable
k = variable
l = uniform location
m = player
n = analyser
o = time
p = program
q = last frame
r = resolution
s = spheres
t = dt
u = uniform wrapper
v = variable
w = variable
x = variable
y = variable
z = variable

G = Gravity
D = Director
C = Math.cos
S = Math.sin
M = CPlayer
Y = render
U = update
P = camera position
T = camera target
E = epoch

H = add
I = sub
J = mul
K = div
L = sum

W = socket
Y = Math.random